OOOOOOOOOOO
O O     O O
O . OO    O
O O O     O
O OOOO  OXO
O O O     U
O OOOOOOO.O
O O       O
O O OOOOOOO
O . O     O
OOOOOOOOOOO
